XSX X
X   X
X   X
XX  X
XX GX
